{
    " " :     "20",
    "A" :     "A1",
    "B" :     "A2",
    "C" :     "A3",
    "D" :     "A4",
    "E" :     "A5",
    "F" :     "A6",
    "G" :     "A7",
    "H" :     "A8",
    "I" :     "A9",
    "J" :     "AA",
    "K" :     "AB",
    "L" :     "AC",
    "M" :     "AD",
    "N" :     "AE",
    "O" :     "AF",
    "P" :     "B0",
    "Q" :     "B1",
    "R" :     "B2",
    "S" :     "B3",
    "T" :     "B4",
    "U" :     "B5",
    "V" :     "B6",
    "W" :     "B7",
    "X" :     "B8",
    "Y" :     "B9",
    "Z" :     "BA",
    "a" :     "BB",
    "b" :     "BC",
    "c" :     "BD",
    "d" :     "BE",
    "e" :     "BF",
    "f" :     "C0",
    "g" :     "C1",
    "h" :     "C2",
    "i" :     "C3",
    "j" :     "C4",
    "k" :     "C5",
    "l" :     "C6",
    "m" :     "C7",
    "n" :     "C8",
    "o" :     "C9",
    "p" :     "CA",
    "q" :     "CB",
    "r" :     "CC",
    "s" :     "CD",
    "t" :     "CE",
    "u" :     "CF",
    "v" :     "D0",
    "w" :     "D1",
    "x" :     "D2",
    "y" :     "D3",
    "z" :     "D4",
    ":" :     "D5",
    ";" :     "D6",
    "!" :     "D7",
    "\"" :    "D8",
    "'" :     "D9",
    "(" :     "DA",
    ")" :     "DB",
    "?" :     "DC",
    "," :     "DD",
    "-" :     "DE",
    "_" :     "DF"
}